image	
cards/trump_swf/back.swf	裏向きの札
cards/trump_swf/clubA.swf	クラブのA
cards/trump_swf/club2.swf	クラブの2
cards/trump_swf/club3.swf	クラブの3
cards/trump_swf/club4.swf	クラブの4
cards/trump_swf/club5.swf	クラブの5
cards/trump_swf/club6.swf	クラブの6
cards/trump_swf/club7.swf	クラブの7
cards/trump_swf/club8.swf	クラブの8
cards/trump_swf/club9.swf	クラブの9
cards/trump_swf/club10.swf	クラブの10
cards/trump_swf/clubJ.swf	クラブのJ
cards/trump_swf/clubQ.swf	クラブのQ
cards/trump_swf/clubK.swf	クラブのK
cards/trump_swf/diaA.swf	ダイアのA
cards/trump_swf/dia2.swf	ダイアの2
cards/trump_swf/dia3.swf	ダイアの3
cards/trump_swf/dia4.swf	ダイアの4
cards/trump_swf/dia5.swf	ダイアの5
cards/trump_swf/dia6.swf	ダイアの6
cards/trump_swf/dia7.swf	ダイアの7
cards/trump_swf/dia8.swf	ダイアの8
cards/trump_swf/dia9.swf	ダイアの9
cards/trump_swf/dia10.swf	ダイアの10
cards/trump_swf/diaJ.swf	ダイアのJ
cards/trump_swf/diaQ.swf	ダイアのQ
cards/trump_swf/diaK.swf	ダイアのK
cards/trump_swf/heartA.swf	ハートのA
cards/trump_swf/heart2.swf	ハートの2
cards/trump_swf/heart3.swf	ハートの3
cards/trump_swf/heart4.swf	ハートの4
cards/trump_swf/heart5.swf	ハートの5
cards/trump_swf/heart6.swf	ハートの6
cards/trump_swf/heart7.swf	ハートの7
cards/trump_swf/heart8.swf	ハートの8
cards/trump_swf/heart9.swf	ハートの9
cards/trump_swf/heart10.swf	ハートの10
cards/trump_swf/heartJ.swf	ハートのJ
cards/trump_swf/heartQ.swf	ハートのQ
cards/trump_swf/heartK.swf	ハートのK
cards/trump_swf/spadeA.swf	スペードのA
cards/trump_swf/spade2.swf	スペードの2
cards/trump_swf/spade3.swf	スペードの3
cards/trump_swf/spade4.swf	スペードの4
cards/trump_swf/spade5.swf	スペードの5
cards/trump_swf/spade6.swf	スペードの6
cards/trump_swf/spade7.swf	スペードの7
cards/trump_swf/spade8.swf	スペードの8
cards/trump_swf/spade9.swf	スペードの9
cards/trump_swf/spade10.swf	スペードの10
cards/trump_swf/spadeJ.swf	スペードのJ
cards/trump_swf/spadeQ.swf	スペードのQ
cards/trump_swf/spadeK.swf	スペードのK
cards/trump_swf/joker.swf	ジョーカー
cards/trump_swf/joker.swf	ジョーカー
cards/trump_swf/joker.swf	ジョーカー
